|###############|
|##EEEEEEEEEEE##|
|##EEEEEEEEEEE##|
|##EEEEEEEEEEE##|
|##EEEEEEEEEEE##|
|##EEEEEEEEEEE##|
|               |
|               |
|               |
|               |
|               |
|               |
|               |
|               |
|#BB###BBB###BB#|
|               |
|               |
|#######P#######|
